###############
# *! *  *+&D  #
#o*~ D  *+~*% #
# *+ *  *%+* %#
# ****  ****  #
#   &     ~   #
# *** **** ** #
#  !* *+&* *  #
#**** ** * * %#
#/*+*%*!   *+ #
# *%* **** *~ #
#~* D *&   %  #
# *** ****D***#
#&%    ~+*  ++#
###############
